TAIL_ID,HEAD_ID,MID_X,MID_Y
N1,S3,0,5
N1,S4,0,5
N1,E2,0,5
N1,W2,0,5
S1,N2,0,5
S1,W2,0,5
S2,N2,0,5
S2,E2,0,5
E1,S3,0,5
E1,S4,0,5
E1,W2,0,5
E1,N2,0,5
W1,S3,0,5
W1,S4,0,5
W1,E2,0,5
W1,N2,0,5